111111111111111111111111111111
1000X00X0X0XX00X00X00X00X00001
100000000000000000X000X0000001
100000000000000000111111000001
100000000000000000000000C00001
1X000P00000C000000000C00100001
110001000001000010000X00000101
110E010ECX0100000000000000X001
111111111111111111111111111111
