11111
1P0X1
1C001
1E001
11111
