11111111111111111111111111111111111111111111111111
10000000000000000000000000000000000000000000000001
10000000000000000000000000000000000000000000000001
10000000000000000000000000000000000000000000000001
10000000000000000000000000000000000000000000000001
10000000000000000000000000000000000000000000000001
10000000000000000000000000000000000000000000000001
10000000000000000000000000000000000000000000000001
10000000000000000000000000000000000000000000000001
10000000000000000000000000000000000001000000000001
10000P00000E00000000000000001000000000000000000001
100000C0000100000010000010000000000000000000000001
10000000000100000000010000000000000000000000000001
100000C00X0100000000000000000000000000000000000001
11111111111111111111111111111111111111111111111111
