111111111111111111111111111111
100000000000000000000000000001
1000000P0000000000000000000001
100000001110000000111111000001
100000001C10000000000000C00001
10000000111C000000000C00100001
110001000001000010000000000101
110E0100C001000000000000000001
111111111111111111111111111111
