111111111111111111111111111111
1000X00X0X0XX00X00X00X00X00001
100000000000000000X000X0000001
100000000000000010111111000001
1000000000000001C1000000C00001
1X000P00000C000111000C00100001
110001000001000010000X00000101
110E0100CX0100000000000000X001
111111111111111111111111111111
