1111111111111111111111111111111111111111111111111111111
10000000P0000000000000000000000000000000000000000000001
100001111111100000000000000000X000000000000000000000001
1000011000000001100000000000000000000000000000000000001
100001100C000001100X00000000000000000000000000X00X0X001
1000011111111100111100111111111111000000000000000000001
1000000000000000100010000000000000010000000000000000001
1000000000000001100010000X0000X000010000000000000000001
1000011111100110000011111111111110011111100000000000001
1000011000000000000001X00000000000100001100000000000001
1000011000C00X00100001X0000000X000100001100000000000001
1000011111111111111111111111111111111111110000000000001
1000000000000000100000000000000000000000000000000000001
100X000001110000000X000000000000000000X0000000000000001
1000000001110000000000000000000000000000000000000000001
1000011111111111111111111111111111111111111111111111111
1000011000000001100000000000000000000000000000000000001
100X01100C0000011000000X00000X0000000000X0000000X000001
1000011111111000111100111111111111000000000000000000001
100000000000000010001C000000000000000000000000000000001
1000000C000000001000100X0000000000010000000000000000001
1000011111100111110011111111111111011111100000000000001
1000011000000001100001X00000000000000001100000000000001
1000011000C00001100001X00000000000100001100000000000001
10000111111111001111111111111111111111111100000C0000001
1000000000000000100000000000000000000000000000000000001
10000000011100000C0000000000000000000000000000000000001
1000000001110000000000000000000000000000000000000000001
10C0000001110000000000000000000000000000000000000000E01
1111111111111111111111111111111111111111111111111111111
