11111111111111111111111111111111111111111111111111111111
10000000000000000000000000000000000000000000000000000001
100E000X10X00X00000000X00000000000000000X0000000X0X00X01
1111111110000000010C0000C0100000000001000000001000000001
10000000000000000111111111100000000001111111111000000001
10000000000000000000000000000000000000000000000000000001
1000000000000000000000000000000100C00X001000000000000001
10000111111111100000000000000001111111111000000000000001
10000000000000000000000000000000000000000000000000000001
10000000000000000000000000000000000000000000000000000001
100000000000000000000C0000000000000000000000000000000001
10000000000000000011111100000000000000001111111111000001
100000000000000000000000C0000000000000000000000000000001
10000P000000000000000C0010000000000100000000100000000001
10000000000000001000000000010000000111111111100000000001
10000000000000000000000000000X0000X000000000000000000001
100000000000000000000000000000000000000000000000X0000001
11111111111111111111111111111111111111111111111111111111
