11111111111111111111111111111111
1P00000000000000C00000000X000001
11001111100000000011111000000001
10000000100000C00000001000000001
1000C00010000000000000100000C001
10111110100111111110001011111001
10000000100000000000100000000001
1C0000000000C00100000000000E0001
10111111111000101111111111110001
10000000000000100000000000000001
1000X0000C000000000C0000000C0001
10000000000000000000000000000001
11111111111111111111111111111111
