11111111111111111111111111111111
1P00000000000000C00000000X000001
10000000000000000000000000000001
10111111100000C00011111000000001
1000C00000000000000000000000C001
10000000000000000000000001111001
10001111110000111111100000000001
1C0000000000C0000000000000000001
10000000000000000000000000E00001
11111111000000000011111111100001
1000X0000C000000000C0000000C0001
10000000000000000000000000000001
11111111111111111111111111111111
