1111111111111111111111111111111111
1P0000000000000000000000000C000001
1001111111111001111111111001111001
10000000000C000000C000000000000001
1011110000111111000011111100011101
1C00001000000000100000000010000001
1110000101111100010111110001111001
1000000100000C000100000C0000000001
10C0000101111111110011111111110001
10000001000000000010000000000C0001
1111100111100011111011110001111101
1000000000C0000000000C0000000C0001
1000000000000000X000000000000000E1
1000C00000000000000000000C00000011
1111111111111111111111111111111111
