1111111111111111111111111111111111111111
1P0000000000000C000000000000000000000001
1001111111100000001111111110000000000001
10000000001000000000000000100000C0000001
10C0000000101111111111000010011111111001
10001111001000000C0000100010000000000001
1000000000100000000000100010000C00000001
1011111111101111111100111110001111110001
1000000000000000C00000000000000000000001
1C00000C000000000000X00000C0000000000E01
1000111111111111111111111111111111100001
1000000000000000000000000000000000000001
1111111111111111111111111111111111111111
