11111111111111111111111111111111
1P0000000C0000000000000000000001
10011111111111111111111111111001
10000000000000000000000000000001
10111111110001111111100111111101
1C00000C001000000C00010000000C01
11100011100101111001001110001111
10000000100100000001000010000001
100C0000100111111111001100000001
10000000001000000000001000000001
10111111111000000C00001111111101
100000000000000X0000000000000E01
10000C0000000000000000C000000001
10111111111111111111111111111101
1C000000000000000000000000000001
1000000000000C00000000000C000001
11111111111111111111111111111111
