111111111111111111111111111111111111
1P00000000000C0000000000000000000001
101111011111011111111111101111110101
10000C0000000100000000001000000C0001
111110111110010111111110100111111101
1C0000100000010000C00000100000000001
111000010111101111011111101111100001
10000001000000000C000000000000100001
100C00001111111111111111111111000C01
10000000000000X000000000000000000001
111110111111011111111011111111111101
1000000000C0000000C00000000C00000001
10C000000000000000000X0000000000E001
111111111111111111111111111111111111
