111111111111111111111111111111
100000000000000000000000000001
10000000000000000000X000000001
10X000000000000000111111000001
100000000000000000000000C00001
10000C00000C000000000C00100001
11000100X001000010000X00000101
110E0100C00100P000000000000001
111111111111111111111111111111
