111111111111111111111111111111
100000000000000000000000000001
100000000000000000000000000001
100000000000000000111111000001
100000000000000000000000C00001
10000C00000C000000000C00100001
110001000001000010000000000101
110E0100C00100P00000X000000001
111111111111111111111111111111
