111111111111111111111111111111
100000000000000000000000000001
100000000000000000000000000001
100000000000000000000000000001
100000000000000000C00000C00001
10000C00000C000000100C00100001
110001000001000000000100000001
110E0100C00100P0X0000000000001
111111111111111111111111111111
