111111111111111111111111111111
100000000000000000000000000001
10000000000000000000000X000001
100000000000000000111111000001
100000000000000000000000C00001
1X000P00000C000000000C00100001
110001000001000010000000000101
110E0100CX0100000000X0000000X1
111111111111111111111111111111
