111111111111111111111111111111
100000000000000000000000000001
100000000000000000000000000001
100000000000000000111111000001
100000000000000000000000C00001
10000P00000C000000000C00100001
110001000001000010000000000101
110E0100CX01000000000000000001
111111111111111111111111111111
