111111111111111111111111111111
100000000000000000000000000001
100000000000000000000000000001
100000000000000000000000000001
100000000000000000000000000001
100000C00000000000100000100001
110001000001000000000100000001
110E01C00X0100P000000000000001
111111111111111111111111111111
