111111111111111
1000000000001111
1000000000000001
10001000000M0001
1000000000000001
1000000000000001
1000000000000001
1000000E00000001
1000000000001001
1000000000001111
1000000000000001
1000000000000001
1000000000000001
1000000000000001
1000000000000001
1111111111111111
