11111111111111111111111111111111111111111111111111111111111111111111111111111111
11110000000000000000000000000000011111111111111111111111111111111111111111111111
10000000000000000000011111000011111111111111111111111111111111111111111111111111
11101111111010000011000011100000011111111111111111111111111111111111111111111111
11101111111111111111000000000000011111111111111111111111111111111111111111111111
10000111000101010101010101000000011111111111111111111111111111111111111111111111
10000000000111000000000000000000011111111111111111111111111111111111111111111111
10000000000100000011111110011100011111111111111111111111111111111111111111111111
11111111111111111111111111111111111111111111111111111111111111111111111111111111

