11111111111111111111111111111111111111111111111111
10000000000000000000000000000000000000000000000001
10000000000000000000000000000000000000000000000001
10000000000000000000000000000000000000000000000001
10000000000000000000000000000000000000000000000001
10000000000000000000000000000000000000000000000001
10000000000000000000000000000000000000000000000001
10000000000000000000000000000000000000000000000001
1000000000000000000000000000000000000C000000000001
1000P000000000000000000000000000000001000000000001
10000000000000C00C00000C00C0000000000U000000000001
100C0000C00C0000000C00C00000C0CC00000U000000000001
10000C000000C000C00C000C00C000CC00000U000000000001
1000000C0X01C000C00000000000C0C000000C000000000001
11111111111111111111111111111111111111111111111111
