11111111111111111111111111111111111111111111111111
10000000000000000000000000000000000000000000000001
10000000000000000000000000000000000000000000000001
10000000000000000000000000000000000000000000000001
10000000000000000000000000000000000000000000000001
10000000000000000000000000000000000000000000000001
10000000000000000000000000000000000000000000000001
10000000000000000000000000000000000000000000000001
1000000000000000000000000000000000000C000000000001
10000000000000000000000000000000000001000000000001
10000P00000000C00C00000C00C01000000000000000000001
100C0000C0010000001C00C01000C0CC000000000000000001
10000C000001C000C00C010C00C000CC000000000000000001
1000000C0X00C000C00000000000C0C000000C000000000001
11111111111111111111111111111111111111111111111111
