11111111111111111111111111111111111111111111111111
10000000000000000000000000000000000000000000000001
10000000000000000000000000000000000000000000000001
10000000000000000000000000000000000000000000000001
10000000000000000000000000000000000000000000000001
10000000000000000000000000000000000000000000000001
10000000000000000000000000000000000000000000000001
10000000000000000000000000000000000000000000000001
10000000000000000000000000000000000000000000000001
10000000000000000000000000000000000001000000000001
1000000000000000000000000000000000000U000000000001
1000000000000000000000000000000000000U000000000001
100000000000P000000000000000000000000U000000000001
100000000X00C000000000000000000000000U000000000001
11111111111111111111111111111111111111111111111111
